AccuracyCurve	Session\Logs\roc_pairs_<DESC>_<DCYNUM>_<SMPL>_<CNG>.xls
AccuracyCurve	Session\Logs\roc_pairs_<DESC>_<DCYNUM>_<SMPL>_<CNG>.xls
BlogsPoolFolder	Corpus\Pairs\
BlogsTextFolder	Corpus\Pairs\
Debug_Log	Session\Logs\debug.txt
DecoySubsetSize	<DcySbStSz>
DecoyTextLength	<DTL>
DirectionalMatch	drc
Epsilon	<Epsilon>
IntersectionType	<INTRTYP>
IRLoops	100
KnownTextLength	<WN>
Lambda	0.0
LetterNgramFreqFloor	0
LogsFolder	Session\Logs\res_pairs_<DESC>_<DCYNUM>_<SMPL>_<CNG>_
MinDecoyLength	405
MinRankToConsider	1
MultiProcessingDegree	3
NameKeyLength	1000
NormFreqByDocs	0
PairClassRes	Session\Logs\res_pairs_<DESC>_<DCYNUM>_<SMPL>_<CNG>.txt
PoolFolder	Corpus\Pairs\
RandomDecoysNumber	<DCYNUM>
RandomSetFreq	0.4
SameAuthorRate	<SAR>
SampleFolder	TestSets\PairsVerification\<SMPL>\
SampleSize	<SmplSz>
ScriptFile	scripts.txt
SelectBlogsRate	0.<SBR>
SelectDecoysFirst	0
SelectDecoysSetSize	250
SimilarityMeasure	mmx
SortedDecoysFile	sorted_decoys.txt
SortTermByFreq	1
SummaryFile	Session\Logs\summary_pairs_<DESC>_<DCYNUM>_<SMPL>_<CNG>.txt
TermAssocMeasure	tfidf
TruePairsNumber	<TPN>
WordNgramFreqFloor	0
WriterRecognzerLen	1000
#include	Session\Params\train_env_blg1k.txt
#include	Session\Params\env_params_gen.txt
#include	Session\Params\lre_ftr_typ_cng.txt
